Deres præmieobligation er udtrukket. De modtager kr. 1.000 af banken.	<Bonus>
I anledning af kongens fødselsdag benådes De herved for fændsel. Dette kort kan opbevares, indtil De får brug for det, eller De kan sælge det.	<OutOfPrison>
De har vundet i Klasselotteriet. Modtag kr. 500.	<Bonus>
Betal kr. 3.000 for reparation af Deres vogn.	<Bonus>
Ryk frem til Strandvejen. Hvis Dew passerer "START", indkasser da kr. 4.000.	<MovePlayer>
Værdien af egen avl fra nyttehaven udgør kr. 200, som De modtager af banken.	<Bonus>
I anledning af Kongens fødselsdag benådes De herved for fændsel. Dette kort kan opbevares, indtil De får brug for det, eller De kan sælge det. <OutOfPrison>
Ryk tre felter tilbage. 	<MovePlayer>
Betal kr. 3.000 for reparaton af Deres vogn.	<Bonus>
De har modtaget Deres tandlægeregning. Betal kr. 2.000.	<Bonus>
Ryk tre felter tilbage. 	<MovePlayer>
Kommunen har eftergivet et kvartals skat. Hæv i banken kr. 3.000.	<Bonus>
De skal holde familiefest og får et tildskud fra hver medspiller på kr. 500. <CashTransfer>
De har lagt penge ud til et sammenskudsgilde. Mærkværdigvis betaler alle straks. Modtag fra hver medspiller kr. 500.	<CashTransfter>
Gå i fængsel. Ryk direkte til fængslet. Selv om De passerer "START", indkasserer De ikke kr. 4.000.	<MovePlayer>
Deres præmieobligation er udtrukket. De modtager kr. 1.000 af banken. 	<Bonus>
Gå i fængsel. Ryk direkte til fængslet. Selv om De passerer "START", indkasserer De ikke kr. 4.000.	<MovePlayer>
Oliepriserne er steget, og De skal betale: kr. 500 pr. hus og kr. 2.000 pr. hotel.	<Bonus>
Betal Deres bilforsikring - kr. 1.000.	<Bonus>
De har vundet i klasselotteriet. Modtag kr. 500.	<Bonus>
Ryk brikken frem til det næremeste rederi og betal ejeren to gange den leje, han ellers er berettiget til. Hvis selskabet ikke ejes af nogen, kan De købe det af banken.	<MovePlayer>
De har solgt nogle gamle møbler på auktion. Modtag kr. 1.000 af banken. 	<Bonus>
Ryk frem til Vimmelskaftet. Hvis de passerer "START", indkasser da kr. 4.000. 	<MovePlayer>
De havde en række med elleve rigtige i tipning. Modtag kr. 1.000.	<Bonus>
De har kørt frem for "Fuldt stop". Betal kr. 1.000 i bøde. 	<Bonus>
Betal for vognsvask og smøring kr. 300.	<Bonus>
De modtager "Matador-legatet for værdigt trængende" på kr. 40.000. Ved værdigt trængende forstås, at Deres formue, dvs. Deres kontante penge + skøder + bygninger, ikke overstiger kr. 15.000. 	<Bonus>
Modtag udbytte af Deres aktier - kr. 1.000. 	<Bonus>
Ryk brikken frem til det nærmeste rederi og betal ejeren to gange den leje, han ellers er berettiget til. Hvis selskabet ikke ejes af nogen, kan De købe det af banken. <MovePlayer>
De har været en tur i udlandet og haft for mange cigaretter med hjem. betal told kr. 200.	<Bonus>
De har købt 4 nye dæk til Deres vogn. Betal kr. 1.000. 	<Bonus>
Grundet dyrtiden har De fået gageforhøjelse. Modtag kr. 1.000. 	<Bonus>
Tag med Mols-Linien. Flyt brikken frem, og hvis De passerer "START", indkasser da kr. 4.000. 	<MovePlayer>
Ryk frem til Frederiksberg Allé. Hvis De passerer "START", indkasser da kr. 4.000. 	<MovePlayer>
Ryk frem til "START". 	<MovePlayer>
De modtager Deres aktieudbytte. Modtag kr. 1.000 af banken. 	<Bonus>
De har fået en parkeringsbøde. Betal kr. 200 i bøde.	<Bonus>
Ejendomsskatterne er steget. Ekstraudgifterne er: kr. 800 pr. hus og kr. 2.300 pr. hotel.	<Bonus>
Det er Deres fødselsdag. Modtag af hver medspiller kr. 200.	<CashTransfer>
Tag ind på Rådhuspladsen.	<MovePlayer>
Ryk frem til Grønnignen. Hvis De passerer "START", indkasser da kr. 4.000. 	<MovePlayer>
Betal kr. 200 for levering af 2 kasser øl. 	<Bonus>
Tag med den næremeste færge. Flyt brikken frem, og hvis De passerer "START",  indkasserer da kr. 4.000. 	<MovePlayer>
Modtag udbytte af Deres aktier - kr. 1.000.	<Bonus>